[console_scripts]
AddElementQuality = ogs._internal.provide_ogs_cli_tools_via_wheel:AddElementQuality
AddFaultToVoxelGrid = ogs._internal.provide_ogs_cli_tools_via_wheel:AddFaultToVoxelGrid
AddLayer = ogs._internal.provide_ogs_cli_tools_via_wheel:AddLayer
AssignRasterDataToMesh = ogs._internal.provide_ogs_cli_tools_via_wheel:AssignRasterDataToMesh
ComputeNodeAreasFromSurfaceMesh = ogs._internal.provide_ogs_cli_tools_via_wheel:ComputeNodeAreasFromSurfaceMesh
CreateBoundaryConditionsAlongPolylines = ogs._internal.provide_ogs_cli_tools_via_wheel:CreateBoundaryConditionsAlongPolylines
ExtractBoundary = ogs._internal.provide_ogs_cli_tools_via_wheel:ExtractBoundary
ExtractMaterials = ogs._internal.provide_ogs_cli_tools_via_wheel:ExtractMaterials
ExtractSurface = ogs._internal.provide_ogs_cli_tools_via_wheel:ExtractSurface
GMSH2OGS = ogs._internal.provide_ogs_cli_tools_via_wheel:GMSH2OGS
GocadSGridReader = ogs._internal.provide_ogs_cli_tools_via_wheel:GocadSGridReader
GocadTSurfaceReader = ogs._internal.provide_ogs_cli_tools_via_wheel:GocadTSurfaceReader
IntegrateBoreholesIntoMesh = ogs._internal.provide_ogs_cli_tools_via_wheel:IntegrateBoreholesIntoMesh
Layers2Grid = ogs._internal.provide_ogs_cli_tools_via_wheel:Layers2Grid
MapGeometryToMeshSurface = ogs._internal.provide_ogs_cli_tools_via_wheel:MapGeometryToMeshSurface
Mesh2Raster = ogs._internal.provide_ogs_cli_tools_via_wheel:Mesh2Raster
MoveGeometry = ogs._internal.provide_ogs_cli_tools_via_wheel:MoveGeometry
MoveMesh = ogs._internal.provide_ogs_cli_tools_via_wheel:MoveMesh
NodeReordering = ogs._internal.provide_ogs_cli_tools_via_wheel:NodeReordering
OGS2VTK = ogs._internal.provide_ogs_cli_tools_via_wheel:OGS2VTK
PVD2XDMF = ogs._internal.provide_ogs_cli_tools_via_wheel:PVD2XDMF
Raster2Mesh = ogs._internal.provide_ogs_cli_tools_via_wheel:Raster2Mesh
RemoveGhostData = ogs._internal.provide_ogs_cli_tools_via_wheel:RemoveGhostData
ReorderMesh = ogs._internal.provide_ogs_cli_tools_via_wheel:ReorderMesh
ResetPropertiesInPolygonalRegion = ogs._internal.provide_ogs_cli_tools_via_wheel:ResetPropertiesInPolygonalRegion
TIN2VTK = ogs._internal.provide_ogs_cli_tools_via_wheel:TIN2VTK
TecPlotTools = ogs._internal.provide_ogs_cli_tools_via_wheel:TecPlotTools
VTK2OGS = ogs._internal.provide_ogs_cli_tools_via_wheel:VTK2OGS
VTK2TIN = ogs._internal.provide_ogs_cli_tools_via_wheel:VTK2TIN
Vtu2Grid = ogs._internal.provide_ogs_cli_tools_via_wheel:Vtu2Grid
addDataToRaster = ogs._internal.provide_ogs_cli_tools_via_wheel:addDataToRaster
appendLinesAlongPolyline = ogs._internal.provide_ogs_cli_tools_via_wheel:appendLinesAlongPolyline
checkMesh = ogs._internal.provide_ogs_cli_tools_via_wheel:checkMesh
computeSurfaceNodeIDsInPolygonalRegion = ogs._internal.provide_ogs_cli_tools_via_wheel:computeSurfaceNodeIDsInPolygonalRegion
constructMeshesFromGeometry = ogs._internal.provide_ogs_cli_tools_via_wheel:constructMeshesFromGeometry
convertGEO = ogs._internal.provide_ogs_cli_tools_via_wheel:convertGEO
convertToLinearMesh = ogs._internal.provide_ogs_cli_tools_via_wheel:convertToLinearMesh
convertVtkDataArrayToVtkDataArray = ogs._internal.provide_ogs_cli_tools_via_wheel:convertVtkDataArrayToVtkDataArray
createIntermediateRasters = ogs._internal.provide_ogs_cli_tools_via_wheel:createIntermediateRasters
createLayeredMeshFromRasters = ogs._internal.provide_ogs_cli_tools_via_wheel:createLayeredMeshFromRasters
createMeshElemPropertiesFromASCRaster = ogs._internal.provide_ogs_cli_tools_via_wheel:createMeshElemPropertiesFromASCRaster
createNeumannBc = ogs._internal.provide_ogs_cli_tools_via_wheel:createNeumannBc
createQuadraticMesh = ogs._internal.provide_ogs_cli_tools_via_wheel:createQuadraticMesh
createRaster = ogs._internal.provide_ogs_cli_tools_via_wheel:createRaster
editMaterialID = ogs._internal.provide_ogs_cli_tools_via_wheel:editMaterialID
generateGeometry = ogs._internal.provide_ogs_cli_tools_via_wheel:generateGeometry
generateMatPropsFromMatID = ogs._internal.provide_ogs_cli_tools_via_wheel:generateMatPropsFromMatID
generateStructuredMesh = ogs._internal.provide_ogs_cli_tools_via_wheel:generateStructuredMesh
geometryToGmshGeo = ogs._internal.provide_ogs_cli_tools_via_wheel:geometryToGmshGeo
identifySubdomains = ogs._internal.provide_ogs_cli_tools_via_wheel:identifySubdomains
ipDataToPointCloud = ogs._internal.provide_ogs_cli_tools_via_wheel:ipDataToPointCloud
moveMeshNodes = ogs._internal.provide_ogs_cli_tools_via_wheel:moveMeshNodes
mpmetis = ogs._internal.provide_ogs_cli_tools_via_wheel:mpmetis
ogs = ogs._internal.provide_ogs_cli_tools_via_wheel:ogs
partmesh = ogs._internal.provide_ogs_cli_tools_via_wheel:partmesh
queryMesh = ogs._internal.provide_ogs_cli_tools_via_wheel:queryMesh
removeMeshElements = ogs._internal.provide_ogs_cli_tools_via_wheel:removeMeshElements
reviseMesh = ogs._internal.provide_ogs_cli_tools_via_wheel:reviseMesh
scaleProperty = ogs._internal.provide_ogs_cli_tools_via_wheel:scaleProperty
swapNodeCoordinateAxes = ogs._internal.provide_ogs_cli_tools_via_wheel:swapNodeCoordinateAxes
tetgen = ogs._internal.provide_ogs_cli_tools_via_wheel:tetgen
vtkdiff = ogs._internal.provide_ogs_cli_tools_via_wheel:vtkdiff
